11111111111111111
10010000000C00011
10000111110011111
1P0011E0000011111111
11111111111111111111
11111111111111111
